Brazil (brazíl) = Brasil
United States (iunáited steits) = Estados Unidos
Canada (kénada) = Canadá
Mexico (méksico) = México
Argentina (ardjêntina) = Argentina
Chile (tchílei) = Chile
Peru (perrú) = Peru
Colombia (colâmbia) = Colômbia
Venezuela (venezúela) = Venezuela
Uruguay (iúruêguai) = Uruguai
England (íngland) = Inglaterra
Scotland (scótland) = Escócia
Ireland (áierland) = Irlanda
France (fréns) = França
Germany (djérmani) = Alemanha
Spain (spéin) = Espanha
Portugal (pórtchugal) = Portugal
Italy (ítali) = Itália
Switzerland (suítsârland) = Suíça
Netherlands (néderlânds) = Holanda
Belgium (bélgiam) = Bélgica
Austria (óstria) = Áustria
Sweden (suídin) = Suécia
Norway (nóruei) = Noruega
Denmark (dénmark) = Dinamarca
Finland (fínland) = Finlândia
Poland (pôuland) = Polônia
Czech Republic (tchék ripâblik) = República Tcheca
Slovakia (slováquia) = Eslováquia
Hungary (rângari) = Hungria
Greece (grís) = Grécia
Turkey (târki) = Turquia
Russia (rásha) = Rússia
Ukraine (iukrêin) = Ucrânia
Romania (roumênia) = Romênia
Bulgaria (bâlgueria) = Bulgária
Croatia (krôuêisha) = Croácia
Serbia (sérbia) = Sérvia
Slovenia (slovênia) = Eslovênia
Bosnia (bósnia) = Bósnia
China (tcháina) = China
Japan (djapán) = Japão
South Korea (sáuth koría) = Coreia do Sul
North Korea (nórth koría) = Coreia do Norte
India (índia) = Índia
Pakistan (pákistan) = Paquistão
Afghanistan (afgánistan) = Afeganistão
Thailand (táiland) = Tailândia
Vietnam (vietnãm) = Vietnã
Philippines (fílipins) = Filipinas
Indonesia (indonízia) = Indonésia
Malaysia (malêizia) = Malásia
Singapore (síngapór) = Singapura
Australia (óstrêilia) = Austrália
New Zealand (niú zíland) = Nova Zelândia
Egypt (ídjit) = Egito
Morocco (morôco) = Marrocos
Algeria (aldjéria) = Argélia
Tunisia (tiunízia) = Tunísia
Libya (líbia) = Líbia
South Africa (sáuth áfrica) = África do Sul
Nigeria (naidjéria) = Nigéria
Kenya (kênia) = Quênia
Ethiopia (itíopia) = Etiópia
Ghana (gána) = Gana
Angola (angôula) = Angola
Mozambique (môuzambíque) = Moçambique
Zimbabwe (zimbábuei) = Zimbábue
Namibia (namíbia) = Namíbia
Botswana (botsuána) = Botsuana
Saudi Arabia (sáudi arêibia) = Arábia Saudita
United Arab Emirates (iunáited érab emírêts) = Emirados Árabes Unidos
Israel (ízrauel) = Israel
Jordan (djórdan) = Jordânia
Lebanon (lébanon) = Líbano
Iran (irã) = Irã
Iraq (iráque) = Iraque
Syria (síria) = Síria
Qatar (kátar) = Catar
Kuwait (kuwêit) = Kuwait
Cuba (kiúba) = Cuba
Jamaica (djameica) = Jamaica
Haiti (rêiti) = Haiti
Dominican Republic (domínican ripâblik) = República Dominicana
Panama (pánama) = Panamá
Costa Rica (cósta ríca) = Costa Rica
Guatemala (guatemála) = Guatemala
Honduras (rondúras) = Honduras
El Salvador (él sálvadôr) = El Salvador
Nicaragua (nikarágua) = Nicarágua
Iceland (áisland) = Islândia
Greenland (grínland) = Groenlândia
Latvia (látvia) = Letônia
Lithuania (lithuênia) = Lituânia
Estonia (estônia) = Estônia
Belarus (bélarus) = Bielorrússia
Georgia (djiórdja) = Geórgia
Armenia (armênia) = Armênia
Azerbaijan (azârbáidjan) = Azerbaijão
Mongolia (mongôlia) = Mongólia
