Agree (agrí) = Concordar
Appear (apíer) = Aparecer
Arrive (arhaíve) = Chegar
Ask (asque) = Pedir/Perguntar
Back (béck) = Voltar
Bathe (beidhe) = Banhar
Believe (belíve) = Acreditar
Break (brâque) = Quebrar
Bring (bhrím) = Trazer
Brush (brâsh) = Escovar
Build (bild) = Construir
Buy (bai) = Comprar
Call (kál) = Ligar/Chamar
Can (kén) = Poder
Care (quero) = Cuidar
Change (chênge) = Mudar
Choose (tchúuz) = Escolher
Close (clôs) = Fechar
Come (cãm) = Vir
Connect (conect) = Ligar/Conectar
Cook (câque) = Cozinhar
Cry (chrái) = Chorar
Cut (kât) = Cortar
Dance (dênce) = Dançar
Decrease (dêcrhis) = Diminuir
Develop (dêvélop) = Desenvolver
Die (dái) = Morrer
Divide (diváid) = Dividir
Do (du) = Fazer
Dream (drhúime) = Sonhar
Dry (drhái) = Secar
Erase (arhês) = Apagar
Explain (écsplén) = Explicar
Fall (fál) = Cair
Feel (fíel) = Sentir
Find (fáind) = Encontrar
Finish (fíniche) = Terminar/Finalizar
Forget (fôrgé) = Esquecer
Get (gét) = Conseguir/Receber
Give (guive) = Dar
Go (gô) = Ir
Grow (grôu) = Crescer
Hate (râiter) = Odiar
Have (héve) = Ter
Hear (ríer) = Ouvir
Help (hélp) = Ajudar
Hit (ríter) = Bater
Hug (râg) = Abraçar
Invite (invai) = Convidar
Jump (dhíampe) = Pular
Know (nôo) = Saber
Laugh (láf) = Rir
Learn (lan) = Aprender
Leave (líve) = Sair
Listen (lísn) = Escutar/Ouvir
Live (laive) = Viver/Morar
Look (lôk) = Olhar
Lose (lú-ous) = Perder
Make (mêke) = Fazer
Obey (ôhbê) = Obedecer
Offer (ófer) = Oferecer
Open (ôpen) = Abrir
Pay (pêi) = Pagar
Protect (protéct) = Proteger
Read (whíd) = Ler
Receive (rhêcíve) = Receber
Remember (rhémembêr) = Lembrar
Run (rhân) = Correr
Say (sei) = Dizer
Search (sôrche) = Procurar
See (si) = Ver
Sell (séu) = Vender
Send (cénde) = Enviar
Show (shôu) = Mostrar
Shine (sháine) = Brilhar
Sing (síngue) = Cantar
Sit (sít) = Sentar
Sleep (slíp) = Dormir
Smile (smai-ol) = Sorrir
Spend (espende) = Passar
Start (estarte) = Começar/Iniciar
Stay (estêy) = Ficar
Study (estâre) = Estudar
Swim (súén) = Nadar
Take (tchêque) = Levar
Teach (thít) = Ensinar
Tell (tél) = Contar
Think (fhínk) = Pensar
Travel (thrável) = Viajar
Try (thrái) = Tentar
Turn off (thrân off) = Desligar
Understand (andesten) = Entender
Wait (uêt) = Esperar
Wake (uêque) = Acordar
Walk (uálque) = Andar/Caminhar
Want (uant) = Querer
Wash (uáche) = Lavar
Watch (uátch) = Assistir
Win (uín) = Ganhar
Write (rhúate) = Escrever
